R 800 600
NO ./textures/bluestone.xpm
SO ./textures/redbrick.xpm
EA ./textures/wood.xpm
WE ./textures/mossy.xpm
S ./textures/pillar.xpm
F 130,131,132
C 150,151,152

11111111111111
10000000000001
10010000000001
10100000000001
1000000000N001
10000000000001
10000000000001
11111111101111
11111111101111
10000000000001
10000000000001
10000000000001
10000000000001
11111111111111
11111111111111
