R 1080 720
NO ./destroyer/wolftex/greystone.png
SO ./destroyer/wolftex/redbrick.png
EA ./destroyer/wolftex/wood.png
WE ./destroyer/wolftex/wood.png
S ./destroyer/wolftex/barrel.png
C 255,200,4
F 122,122,122

1111
10N1
1001
2111