R 600 600
NO ./wolftex1/greystone.png
SO ./wolftex1/redbrick.png
EA ./wolftex1/wood.png
WE ./wolftex1/wood.png
S ./wolftex1/barrel.png
F 130,131,132
C 150,151,152

1111111
1000001
1000001
1000011
1000001
1000001
100N001
1111111


