R 1000 1000
NO ./wolftex1/greystone.png
SO ./wolftex1/redbrick.png
EA ./wolftex1/wood.png
WE ./wolftex1/wood.png
S ./wolftex1/barrel.png
F 130,131,132
C 150,151,152

111111111
100000001
101000001
100000001
100000001
100000001
1000N0001
111111111
