R 300 300
NO ./wolftex1/greystone.png
SO ./wolftex1/redbrick.png
EA ./wolftex1/wood.png
WE ./wolftex1/wood.png
S ./wolftex1/barrel.png
F 130,131,132
C 150,151,152

1111111111111
1000001000001
1000001000001
1000111000001
1000001000001
1000000000001
100000N000001
1000000000001
1111111111111