R 1920 1080
NO ./textures/bluestone.xpm
SO ./textures/redbrick.xpm
EA ./textures/wood.xpm
WE ./textures/mossy.xpm
S ./textures/pillar.xpm
F 192,64,64
C 86,167,220

11111111111111
10000000000001
10010000000001
10100000000001
10000000N00001
10000000000001
10000000000001
11111111101111
11111111101111
10000000000001
10000000000001
10000000000001
10000000000001
11111111111111
11111111111111
