R 100 720
WE ./destroyer/wolftex/greystone.png
SO ./destroyer/wolftex/redbrick.png
EA ./destroyer/wolftex/wood.png
NO ./destroyer/wolftex/wood.png
S ./destroyer/wolftex/barrel.png
C 255,200,160
F 122,122,122

1111
10N1
1001
1111