R 1920 1080
NO ./textures/bluestone.xpm
SO ./textures/redbrick.xpm
EA ./textures/wood.xpm
WE ./textures/mossy.xpm
S ./textures/pillar.xpm
F 192,64,64
C 86,167,220

11111111111111111111111111111111111111111111111111
11111101011011100111111001011101201111100012201011
11010002011101120000110100000100011021111010100011
10112010010120211000010001010100000111101010020001
11000000100000011000001100001100110001121010101011
10111000100011000010120000110100100100011201100001
10001120011100000001111010101102011101012010101011
10110101010101110101201101001001000100101011101111
11101001100011001121010001010211102011011010120001
11101000001212110110102001001201101010001100110111
10110010100000111010001110001001001010211111000011
11001111001112101110111110020100200021110101011001
10001101011000011000011110010110010020110000011011
10010000000000111100101101000011002000111010001111
10110000200000010010010211111110101002020000000001
10101001001000101002012001011100111210100201111101
10011010010010010101101010001100001001210100100011
10201111000001021001110011011011101010210110000101
10011111011100011200111210010201101111101101100111
10021101001100012000100011001000000101111001110011
10111010110021110012210100111110110210100101011001
11101110011000120110011100110110100011111002110101
11110110011000000112100100100000011100010121111001
10101012210111001010101111010011011211100000010211
11010110101111001000110011100210011011101110110011
101110011000000S1101011011210000101000010010011111
11010101100100111210100000011101001101011110001211
11000011111101111000001111111102121011011000000001
10110200001100010112011100201121000000010010010111
10101011011111111011011101101001200110001001011001
11010110221011101010112201001100001100011101101001
11111010110100100021010211100100010111001111101001
10001110010011001010110111100000000100000100100211
10110000111100110101111111010101000001000000111111
10210110011110000010010111101001010020010201011111
11011010100111000111001010010001100000201111111111
11010102000100001102000101100001110000000111100101
10001110001010001011010001010001111000102101101101
11010000110002101020100002100101102011010001111101
11000100011011110121010111110100001011111101000111
10000101100110001100112001000010101011011110010111
11201000011010001111111111001110111011100000000011
11101000101101100001100110111000001101002001110001
10101101011001111102011100100101110101011011110011
11101100111110100000100011111101000001201001011101
11000000110100010100120020110121010001111010001011
10100100010010001101100020010101110101010100010011
10100101110101010000111010012000010120010002020001
11110100011110020001110101000100011120100110101021
11111111111111111111111111111111111111111111111111
