R 1920 1080
NO ./textures/bluestone.xpm
SO ./textures/redbrick.xpm
EA ./textures/wood.xpm
WE ./textures/mossy.xpm
S ./textures/pillar.xpm
F     132,64,64
C 86,167,220

111111  111111
100001  100001
100101  100001
101001  100001
100001  100001
10000111100001
100000000N0001
11111111101111
11111111101111
10000000000001
10000000000001
10000002000001
10000000000001
11111111111111