R 1920 1080
NO ./textures/bluestone.xpm
SO ./textures/redbrick.xpm
EA ./textures/wood.xpm
WE ./textures/mossy.xpm
S ./textures/pillar.xpm
F 192,64,64
C 86,167,220

11111111111111
10000022200001
10010000000201
10100000000201
10000000E00201
10000000000001
10000000000001
11111111101111
11111111101111
10000000000001
10000000000001
10000002000001
10000000000001
11111111111111
11111111111111
