R 1080 720
SO ./wolftex/redbrick.png
EA ./wolftex/wood.png  	
NO ./wolftex/greystone.png
WE ./wolftex/wood.png		 
S ./wolftex/barrel.png
C 255,200,160	 	 
F 122,122,122	 
			  
11111
1N001
10001
11111